#####
     #   ##
     #    #
 ######   #
##     #. #
# $ $ @  ##
# ######.#
#        #
##########