########
 #  @   #
 # $  $ #
### ## ###
#  $..$  #
#   ..   #
##########