#######
###     #
# $ $   #
# ### #####
# @ . .   #
#   ###   #
##### #####