####
  #  #
  # $####
###. .  #
# $ # $ #
#  . .###
####$ #
   # @#
   ####