####
###  #####
#  $  @..#
# $    # #
### #### #
  #      #
  ########