####
##  ####
#   ...#
#   ...#
#   # ##
#   #@ #### ####
##### $   ###  #
    #  ##$ $   #
   ###     $$  #
   # $  ##   ###
   #    ######
   ######