####
### @#
#  $ #
#  *.#
#  *.#
#  $ #
###  #
  ####