########
  #  # . #
  #   .*.#
  #  # * #
####$##.##
#      $ #
# $ ## $ #
#   @#   #
##########