     ###
##### #.#
#   ###.#
#   $ #.#
# $  $  #
#####@# #
    #   #
    #####