#####
   ###   #
####.....#
# @$$$$$ #
#     # ##
#####   #
    #####