#######
## ....##
#   ######
#   $ $ @#
###  $ $ #
  ###    #
    ######