#######
# #     #
# # # # #
  # @ $ #
### ### #
#   ### #
# $  ##.#
## $  #.#
 ## $  .#
# ## $#.#
## ## #.#
### #   #
### #####