####
 #######  #
 # $      #
 #   $ $  #
 # ########
## # .  #
#  # #  #
#  @ . ##
## # # #
 #   . #
 #######